#######
#.....#
#.###.#
#.#.#.#
#.#.#.#
#.....#
#######
\robot 3 1
\robot 2 1
\robot 1 1