########################################
#......................................#
#......................................#
#......................................#
#......................................#
#.....######.........######............#
#.....######.........######............#
#.....######.........######............#
#......................................#
#......................................#
#......................................#
#......................................#
#............######.........######.....#
#............######.........######.....#
#............######.........######.....#
#......................................#
#......................................#
#......................................#
#......................................#
#.....######.........######............#
#.....######.........######............#
#.....######.........######............#
#......................................#
#......................................#
#......................................#
#......................................#
#............######.........######.....#
#............######.........######.....#
#............######.........######.....#
#......................................#
#......................................#
#......................................#
#......................................#
#.....######.........######............#
#.....######.........######............#
#.....######.........######............#
#......................................#
#......................................#
#......................................#
########################################
\robot 1 1
