###############
#.............#
#.............#
#..#####......#
#..#####......#
#..#####......#
#.............#
#.............#
#.............#
#......#####..#
#......#####..#
#......#####..#
#.............#
#.............#
###############
